111111111111111111111111111111 
100000000000000000000000000001 
101111111111111111111111111101 
101000000000000000000000000101 
101011111111111111111111110101 
101010000000000000000000010101 
101010111111111111111110010101 
101010100000000000000010010101 
101010101111111111111010010101 
101010101000000000001010010101 
101010101011111111101010010101 
101010101010000000101010010101 
101010101010111110101010010101 
101010101010100010101010010101 
101010101010101110101010010101 
101010101010101010101010010101 
101010101010101010101010010101 
101010101010101010101010010101 
101010101010101010101010010101 
101010101010101010101010010101 
101010101010101010101010010101 
101010101010101010101010010101 
101010101010101010101010010101 
101010101010101010101010010101 
101010101010101010101010010101 
101010101010101010101010010101 
101010101010101010101010010101 
101010101010101010101010010101 
100000000000000000000000000001 
111111111111111111111111111111